........#######......######....................................#
........#######......######....................................#
........#######.......................................#####....#
........#######..................######........................#
........#######......######....................................#
........#######......######...................#######........###
........#######......######.............................##.....#
........#######......######....##..............................#
...P...........................................................#
#####..................................#########################
#####.E.........................################################
###############......###########################################
###############......###########################################
###############......###########################################
###############......###########################################
###############......###########################################
###############......###########################################
###############......###########################################
................................................................
.####....##.......................#######.....................##
................................................................
................................................................
######..##########............###############.........##########
######..........................................................
......................###.......................####............
................................#.....####......................
###############...........##....#.....####................##....
###############.................#.....########..............####
############........##..........#.....####..................####
#########...............................................####....
..........................######################........####....
#################..................................##...........